MMW1W1W1W1W1W1W1W1W1W1W1W1W1W1W1W1W1W1W1
A1A2W2W2W2W2W2W2W2W2W2W2W2W2W2W2W2W2W2E1
A1A2A3W3W3W3W3W3W3W3W3W3W3W3W3W3W3W3E2E1
A1A2A3A4W4W4W4W4W4W4W4W4W4W4W4W4W4E3E2E1
A1A2A3A4A5W5W5W5W5W5W5W5W5W5W5W5E4E3E2E1
A1A2A3A4A5A6W6W6W6W6W6W6W6W6W6E5E4E3E2E1
A1A2A3A4A5A6A7W7W7W7W7W7W7W7E6E5E4E3E2E1
A1A2A3A4A5A6A7A8W8W8W8W8W8E7E6E5E4E3E2E1
A1A2A3A4A5A6A7A8A9W9W9W9E8E7E6E5E4E3E2E1
A1A2A3A4A5A6A7A8A9A9GGE9E8E7E6E5E4E3E2E1
A1A2A3A4A5A6A7A8A9A9E9E9E8E7E6E5E4E3E2E1
A1A2A3A4A5A6A7A8E9E9E9E9E8E7E6E5E4E3E2E1
A1A2A3A4A5A6A7E8E8E8E8E8E8E7E6E5E4E3E2E1
A1A2A3A4A5A6E7E7E7E7E7E7E7E7E6E5E4E3E2E1
A1A2A3A4A5E6E6E6E6E6E6E6E6E6E6E5E4E3E2E1
A1A2A3A4E5E5E5E5E5E5E5E5E5E5E5E5E4E3E2E1
A1A2A3A4E4E4E4E4E4E4E4E4E4E4E4E4E4E3E2E1
A1A2A3E3E3E3E3E3E3E3E3E3E3E3E3E3E3E3E2E1
A1A2E2E2E2E2E2E2E2E2E2E2E2E2E2E2E2E2E2E1
A1E1E1E1E1E1E1E1E1E1E1E1E1E1E1E1E1E1E1E1
