W9A4E9W2A9
A5W2E2W4W2
E0A0E2GGE7
A8A0A2A7E9
MMW6W1W9A5
